# # # # # # # # # # # # # # # # #
# . . . . . . # . . . . # . # . #
# # # # # . # # # . . . . . # . #
# . . . . ~ ~ ~ . . . # . . . * #
# . # # # ~ # . # . # . # . # * #
# . # . # ~ ~ ~ . . . # . . # * #
# . # . # . . # . # . # . . # . #
# . # . . . . # # . # . . # . . #
# * . . # # # . . # . . . . . # #
# * * * * . . . # # . . # # . . #
# # # # . # # . . # . . . . # . #
# . . . . # . . . . . . # # . . #
# . # # . # . # . . . . . . . . #
# # # # # # # # # # # # # # # # #
