# # # # # # # # # # # # # # # # #
# . . . . . . # . . . . # . # . #
# # # # # . # . . . . # . . . # #
# . . ~ . . . . . . . # . . . * #
# . # # # ~ . . . . # . # . # * #
# . # . # ~ # . # . . . # . # * #
# . # . # ~ # . # # # . # # # . #
# . # . . ~ . . . # . . # . . . #
# * . . # # # . ~ # . . . . # # #
# * * * * . . . # # . . . . . . #
# # # # . # . # # . . . # . # . #
# . . . . . . # . . . # # . . . #
# . # # . . . . . # . . . . . . #
# # # # # # # # # # # # # # # # #
