# # # # # # # # # # # # # # # # #
# ~ . . # . . . . . . # . # . . #
# # # # # . # # # . . . . # . # #
# . . . . ~ ~ ~ . . . # . . . * #
# . # # # ~ # . # . # . # . # * #
# . # . # ~ # . # . # . # . # * #
# . # . # ~ # . # . . # # . # . #
# . # . . ~ # . # # . # . # . . #
# * . . # # # . ~ # . . . . . # #
# * * * * . . . # # . # # . . . #
# # # # . # . . . # . # . . # . #
# . . . . # . # . . . # # . # . #
# . # # . # . # . # . . . . . . #
# # # # # # # # # # # # # # # # .
