# # # # # # # # # # # # # # # # # # # # # # # # # # # # # # # # # # # # # # # # # # # # # # # # # #
# . . . . . . # . . . . . . . . # . . . # . # . . . . . # . . . . # . # . . . . . . . # . . . # . #
# # # # # . # # . . . . # . . # # . . # # # . # . . . # # . # # # # . . # . . # # # . # . . . . # #
# . ~ ~ ~ . . . . . . . . . . # . . . . . . . # . # . # . . . # * . . . . . . . . . . . # . # * . #
# . # # # ~ # . # # . # # # . . * . . . . # # # . . # # . . . . . . # # . # . . # . # . . # . . # #
# . # . # ~ ~ ~ . . # . . # # . * . . # . . . . . . . . . . # . . . . . . . . . . # . . . . # # . #
# . # . # ~ # . . . # . . # . . * * * * # . # . # . # # . . . . . . . . . . . . . . . . # . # . . #
# . # . . ~ # . # . # # # # . . # * * * . * . . . . . . # . # . . . # # . # . # . # # # # . . # . #
# * . . # # # . ~ # . . . . . . . ~ * * . * . . . . . . # # . . # . # # # . . . . . . . # . # # . #
# * * * * . . . # # . . . . . . . ~ * * . * . . . # # . . . # # . . . . . . . . . . # . # . # . # #
# # # # . # . . . # . # . . . . . ~ . . . * . . . . # . . # . . . . . # . . . . . # . . # . . # # #
# . . . . # . # # . . . . . . . . ~ . . . # # . . . # # . . . . # . # . . . # . . . . # . # . . . #
# . # # . . . # . # . ~ ~ ~ ~ ~ ~ ~ . . # # . . . # . . # . . # . # . . . # . # # . . . . . # . # #
# . . . . . . # . . . . . . . # . . . . . . # . # # # . . . . # . # . . . . . . . . . . . # . . . #
# # # # # # # # # . # # # # # # # # # # # # # # # # . # # # # # # # # # # # # # # # # # # # # # # #
# . . . . . . . . . # . # ~ ~ . . . . # . . . # . # . . . . # . . . # . . . . . . . . . # . . . . #
# # . . # # # . # # # . # ~ ~ # . . . # # . # # # # . . . # # . # . . . # . # # . # . . . # . # . #
# . ~ . . ~ ~ ~ . . # . . ~ . # . . . . . . . . . . . . # . . . . . . . . . . # . # # . . . . . . #
# . # . # # # # # . . # . ~ . . . . . . # # # . . . # . . . . . ~ . . . . . # . . . . . . # . . . #
# . # . . # # # # # . # . ~ # . . . . . . . . . # . . . . ~ . . ~ . . . . . . . . . . . . # # . . #
# . # # # # # # # . # . . ~ # # # # # . . . . . . . . . . ~ . . ~ . # . . . . . . . . . # . . # . #
# . . . . . . # # # . . . ~ . . . . . . # . # . . # . . . ~ . . ~ . . # . . . . . . . # . . . . # #
# # # . . . ~ ~ ~ ~ ~ ~ . ~ ~ . . . . . . # . # . ~ ~ ~ ~ ~ ~ ~ ~ . . . . . . . . . # . . . # . # #
# . . . . # . . . . . . . . ~ . # . . . . . # . # . . . . . . . . . . . . . . . . . . . . . . . . #
# # # # . # . . . # . # . . ~ . . . . . . . . . . . # . . # . . . . . # . . . . . # . . # . . # # #
# . . . . # . # # . . . . . ~ . . . . . . # # . . . # # . . . . # . # . . . # . . . . # . # . . . #
# . . . . . . . . . # . # . ~ . . . . # . . . # . # . . . . # . . . # . . . . . . . . . # . . . . #
# # # # # # # # # # # # # # # # # # # # # # # # # # # # # # # # # # # # # # # # # # # # # # # # # #
