# # # # # # # # # # # # # # # # #
# . . . . . . # . . . . # . # . #
# # # # # . # # . . # . # # # # #
# . ~ ~ ~ . . . . . # . # . . * #
# . # # # ~ # . # # . # . . # * #
# . # . # ~ ~ ~ . . # . # . # * #
# . # . # ~ # . . . # . . # . . #
# . # . . ~ # . # . # # # # . . #
# * . . # # # . ~ # . . . . . # #
# * * * * . . . # # . . . # # . #
# # # # . # . . . # . # . . # . #
# . . . . # . # # . . . # # . # #
# . # # . . . # . # . . . . . . #
# # # # # # # # # # # # # # # # #